Rank,NOC,Gold,Silver,Bronze,Total,Year,Medal_Score,Medal_Share
1,USA,11,7,2,20,1896,49,0.16393442622950818
2,GRE,10,18,19,47,1896,85,0.38524590163934425
3,GER,6,5,2,13,1896,30,0.10655737704918032
4,FRA,5,4,2,11,1896,25,0.09016393442622951
5,GBR,2,3,2,7,1896,14,0.05737704918032787
6,HUN,2,1,3,6,1896,11,0.04918032786885246
7,AUT,2,1,2,5,1896,10,0.040983606557377046
8,AUS,2,0,0,2,1896,6,0.01639344262295082
9,DEN,1,2,3,6,1896,10,0.04918032786885246
10,SUI,1,2,0,3,1896,7,0.02459016393442623
11,MIX,1,0,1,2,1896,4,0.01639344262295082
1,FRA,27,39,37,103,1900,196,0.3626760563380282
2,USA,19,14,15,48,1900,100,0.16901408450704225
3,GBR,15,7,9,31,1900,68,0.10915492957746478
4,MIX,8,5,6,19,1900,40,0.06690140845070422
5,BEL,6,7,4,17,1900,36,0.05985915492957746
6,SUI,6,2,1,9,1900,23,0.03169014084507042
7,GER,4,3,2,9,1900,20,0.03169014084507042
8,ITA,3,2,0,5,1900,13,0.017605633802816902
9,AUS,2,0,3,5,1900,9,0.017605633802816902
10,DEN,1,3,2,6,1900,11,0.02112676056338028
11,HUN,1,2,2,5,1900,9,0.017605633802816902
12,CUB,1,1,0,2,1900,5,0.007042253521126761
13,CAN,1,0,1,2,1900,4,0.007042253521126761
14,ESP,1,0,0,1,1900,3,0.0035211267605633804
14,LUX,1,0,0,1,1900,3,0.0035211267605633804
16,AUT,0,3,3,6,1900,9,0.02112676056338028
17,NOR,0,2,3,5,1900,7,0.017605633802816902
17,NED,0,2,3,5,1900,7,0.017605633802816902
19,IND,0,2,0,2,1900,4,0.007042253521126761
20,BOH,0,1,1,2,1900,3,0.007042253521126761
21,SWE,0,0,1,1,1900,1,0.0035211267605633804
1,USA,76,78,77,231,1904,461,0.825
2,GER,4,5,6,15,1904,28,0.05357142857142857
3,CAN,4,1,1,6,1904,15,0.02142857142857143
4,CUB,3,0,0,3,1904,9,0.010714285714285714
5,HUN,2,1,1,4,1904,9,0.014285714285714285
5,MIX,2,1,1,4,1904,9,0.014285714285714285
7,NOR,2,0,0,2,1904,6,0.007142857142857143
8,AUT,1,1,1,3,1904,6,0.010714285714285714
9,GBR,1,1,0,2,1904,5,0.007142857142857143
10,SUI,1,0,2,3,1904,5,0.010714285714285714
11,GRE,1,0,1,2,1904,4,0.007142857142857143
12,AUS,0,3,1,4,1904,7,0.014285714285714285
13,FRA,0,1,0,1,1904,2,0.0035714285714285713
1,GBR,56,51,39,146,1908,309,0.4506172839506173
2,USA,23,12,12,47,1908,105,0.14506172839506173
3,SWE,8,6,11,25,1908,47,0.07716049382716049
4,FRA,5,5,9,19,1908,34,0.05864197530864197
5,GER,3,5,5,13,1908,24,0.040123456790123455
6,HUN,3,4,2,9,1908,19,0.027777777777777776
7,CAN,3,3,10,16,1908,25,0.04938271604938271
8,NOR,2,3,3,8,1908,15,0.024691358024691357
9,ITA,2,2,0,4,1908,10,0.012345679012345678
10,BEL,1,5,2,8,1908,15,0.024691358024691357
11,ANZ,1,2,2,5,1908,9,0.015432098765432098
12,RU1,1,2,0,3,1908,7,0.009259259259259259
13,FIN,1,1,3,5,1908,8,0.015432098765432098
14,RSA,1,1,0,2,1908,5,0.006172839506172839
15,GRE,0,3,1,4,1908,7,0.012345679012345678
16,DEN,0,2,3,5,1908,7,0.015432098765432098
17,BOH,0,0,2,2,1908,2,0.006172839506172839
17,NED,0,0,2,2,1908,2,0.006172839506172839
19,AUT,0,0,1,1,1908,1,0.0030864197530864196
1,USA,26,19,19,64,1912,135,0.20512820512820512
2,SWE,23,25,17,65,1912,136,0.20833333333333334
3,GBR,10,15,16,41,1912,76,0.13141025641025642
4,FIN,9,8,9,26,1912,52,0.08333333333333333
5,FRA,7,4,3,14,1912,32,0.04487179487179487
6,GER,5,13,7,25,1912,48,0.08012820512820513
7,RSA,4,2,0,6,1912,16,0.019230769230769232
8,NOR,3,2,5,10,1912,18,0.03205128205128205
9,CAN,3,2,3,8,1912,16,0.02564102564102564
9,HUN,3,2,3,8,1912,16,0.02564102564102564
11,ITA,3,1,2,6,1912,13,0.019230769230769232
12,ANZ,2,2,3,7,1912,13,0.022435897435897436
13,BEL,2,1,3,6,1912,11,0.019230769230769232
14,DEN,1,6,5,12,1912,20,0.038461538461538464
15,GRE,1,0,1,2,1912,4,0.00641025641025641
16,RU1,0,2,3,5,1912,7,0.016025641025641024
17,AUT,0,2,2,4,1912,6,0.01282051282051282
18,NED,0,0,3,3,1912,3,0.009615384615384616
1,USA,41,27,27,95,1920,204,0.21689497716894976
2,SWE,19,20,25,64,1920,122,0.1461187214611872
3,FIN,15,10,9,34,1920,74,0.0776255707762557
4,GBR,14,15,13,42,1920,85,0.0958904109589041
5,BEL,14,11,11,36,1920,75,0.0821917808219178
6,NOR,13,9,9,31,1920,66,0.07077625570776255
7,ITA,13,5,5,23,1920,54,0.05251141552511415
8,FRA,9,19,13,41,1920,78,0.09360730593607305
9,NED,4,2,5,11,1920,21,0.02511415525114155
10,DEN,3,9,1,13,1920,28,0.02968036529680365
11,RSA,3,4,3,10,1920,20,0.0228310502283105
12,CAN,3,3,3,9,1920,18,0.02054794520547945
13,SUI,2,2,7,11,1920,17,0.02511415525114155
14,EST,1,2,0,3,1920,7,0.00684931506849315
15,BRA,1,1,1,3,1920,6,0.00684931506849315
16,AUS,0,2,1,3,1920,5,0.00684931506849315
17,JPN,0,2,0,2,1920,4,0.0045662100456621
17,ESP,0,2,0,2,1920,4,0.0045662100456621
19,GRE,0,1,0,1,1920,2,0.00228310502283105
19,LUX,0,1,0,1,1920,2,0.00228310502283105
21,TCH,0,0,2,2,1920,2,0.0045662100456621
22,NZL,0,0,1,1,1920,1,0.00228310502283105
1,USA,45,27,27,99,1924,216,0.2619047619047619
2,FIN,14,13,10,37,1924,78,0.09788359788359788
3,FRA,13,15,10,38,1924,79,0.10052910052910052
4,GBR,9,13,12,34,1924,65,0.08994708994708994
5,ITA,8,3,5,16,1924,35,0.042328042328042326
6,SUI,7,8,10,25,1924,47,0.06613756613756613
7,NOR,5,2,3,10,1924,22,0.026455026455026454
8,SWE,4,13,12,29,1924,50,0.07671957671957672
9,NED,4,1,5,10,1924,19,0.026455026455026454
10,BEL,3,7,3,13,1924,26,0.03439153439153439
11,AUS,3,1,2,6,1924,13,0.015873015873015872
12,DEN,2,5,2,9,1924,18,0.023809523809523808
13,HUN,2,3,4,9,1924,16,0.023809523809523808
14,YUG,2,0,0,2,1924,6,0.005291005291005291
15,TCH,1,4,5,10,1924,16,0.026455026455026454
16,ARG,1,3,2,6,1924,11,0.015873015873015872
17,EST,1,1,4,6,1924,9,0.015873015873015872
18,RSA,1,1,1,3,1924,6,0.007936507936507936
19,URU,1,0,0,1,1924,3,0.0026455026455026454
20,AUT,0,3,1,4,1924,7,0.010582010582010581
20,CAN,0,3,1,4,1924,7,0.010582010582010581
22,POL,0,1,1,2,1924,3,0.005291005291005291
23,HAI,0,0,1,1,1924,1,0.0026455026455026454
23,JPN,0,0,1,1,1924,1,0.0026455026455026454
23,NZL,0,0,1,1,1924,1,0.0026455026455026454
23,POR,0,0,1,1,1924,1,0.0026455026455026454
23,ROU,0,0,1,1,1924,1,0.0026455026455026454
1,USA,22,18,16,56,1928,118,0.1712538226299694
2,GER,10,7,14,31,1928,58,0.09480122324159021
3,FIN,8,8,9,25,1928,49,0.0764525993883792
4,SWE,7,6,12,25,1928,45,0.0764525993883792
5,ITA,7,5,7,19,1928,38,0.0581039755351682
6,SUI,7,4,4,15,1928,33,0.045871559633027525
7,FRA,6,10,5,21,1928,43,0.06422018348623854
8,NED,6,9,4,19,1928,40,0.0581039755351682
9,HUN,4,5,0,9,1928,22,0.027522935779816515
10,CAN,4,4,7,15,1928,27,0.045871559633027525
11,GBR,3,10,7,20,1928,36,0.06116207951070336
12,ARG,3,3,1,7,1928,16,0.021406727828746176
13,DEN,3,1,2,6,1928,13,0.01834862385321101
14,TCH,2,5,2,9,1928,18,0.027522935779816515
15,JPN,2,2,1,5,1928,11,0.01529051987767584
16,EST,2,1,2,5,1928,10,0.01529051987767584
17,EGY,2,1,1,4,1928,9,0.012232415902140673
18,AUT,2,0,1,3,1928,7,0.009174311926605505
19,AUS,1,2,1,4,1928,8,0.012232415902140673
19,NOR,1,2,1,4,1928,8,0.012232415902140673
21,POL,1,1,3,5,1928,8,0.01529051987767584
21,YUG,1,1,3,5,1928,8,0.01529051987767584
23,RSA,1,0,2,3,1928,5,0.009174311926605505
24,IND,1,0,0,1,1928,3,0.0030581039755351682
24,IRL,1,0,0,1,1928,3,0.0030581039755351682
24,NZL,1,0,0,1,1928,3,0.0030581039755351682
24,ESP,1,0,0,1,1928,3,0.0030581039755351682
24,URU,1,0,0,1,1928,3,0.0030581039755351682
29,BEL,0,1,2,3,1928,4,0.009174311926605505
30,CHI,0,1,0,1,1928,2,0.0030581039755351682
30,HAI,0,1,0,1,1928,2,0.0030581039755351682
32,PHI,0,0,1,1,1928,1,0.0030581039755351682
32,POR,0,0,1,1,1928,1,0.0030581039755351682
1,USA,44,36,30,110,1932,234,0.2972972972972973
2,ITA,12,12,12,36,1932,72,0.0972972972972973
3,FRA,11,5,4,20,1932,47,0.05405405405405406
4,SWE,10,5,9,24,1932,49,0.06486486486486487
5,JPN,7,7,4,18,1932,39,0.04864864864864865
6,HUN,6,5,5,16,1932,33,0.043243243243243246
7,GER,5,12,7,24,1932,46,0.06486486486486487
8,FIN,5,8,12,25,1932,43,0.06756756756756757
9,GBR,5,7,5,17,1932,34,0.04594594594594595
10,POL,3,2,4,9,1932,17,0.024324324324324326
11,AUS,3,1,1,5,1932,12,0.013513513513513514
12,ARG,3,1,0,4,1932,11,0.010810810810810811
13,CAN,2,5,9,16,1932,25,0.043243243243243246
14,NED,2,5,1,8,1932,17,0.021621621621621623
15,RSA,2,0,3,5,1932,9,0.013513513513513514
16,IRL,2,0,0,2,1932,6,0.005405405405405406
17,TCH,1,3,2,6,1932,11,0.016216216216216217
18,AUT,1,1,3,5,1932,8,0.013513513513513514
19,IND,1,0,0,1,1932,3,0.002702702702702703
20,DEN,0,5,3,8,1932,13,0.021621621621621623
21,MEX,0,2,0,2,1932,4,0.005405405405405406
22,LAT,0,1,0,1,1932,2,0.002702702702702703
22,NZL,0,1,0,1,1932,2,0.002702702702702703
22,SUI,0,1,0,1,1932,2,0.002702702702702703
25,PHI,0,0,3,3,1932,3,0.008108108108108109
26,BEL,0,0,1,1,1932,1,0.002702702702702703
26,ESP,0,0,1,1,1932,1,0.002702702702702703
26,URU,0,0,1,1,1932,1,0.002702702702702703
1,GER,38,31,32,101,1936,208,0.23933649289099526
2,USA,24,21,12,57,1936,126,0.13507109004739337
3,HUN,10,1,5,16,1936,37,0.037914691943127965
4,ITA,9,13,5,27,1936,58,0.06398104265402843
5,FIN,8,6,6,20,1936,42,0.04739336492890995
6,FRA,7,6,6,19,1936,39,0.045023696682464455
7,SWE,6,5,10,21,1936,38,0.04976303317535545
8,JPN,6,4,10,20,1936,36,0.04739336492890995
9,NED,6,4,7,17,1936,33,0.04028436018957346
10,AUT,5,7,5,17,1936,34,0.04028436018957346
11,SUI,4,9,5,18,1936,35,0.04265402843601896
12,GBR,4,7,3,14,1936,29,0.03317535545023697
13,TCH,3,5,1,9,1936,20,0.02132701421800948
14,ARG,2,2,3,7,1936,13,0.016587677725118485
14,EST,2,2,3,7,1936,13,0.016587677725118485
16,EGY,2,1,2,5,1936,10,0.011848341232227487
17,CAN,1,3,5,9,1936,14,0.02132701421800948
18,NOR,1,3,2,6,1936,11,0.014218009478672985
19,TUR,1,0,1,2,1936,4,0.004739336492890996
20,IND,1,0,0,1,1936,3,0.002369668246445498
20,NZL,1,0,0,1,1936,3,0.002369668246445498
22,POL,0,4,5,9,1936,13,0.02132701421800948
23,DEN,0,2,3,5,1936,7,0.011848341232227487
24,LAT,0,1,1,2,1936,3,0.004739336492890996
25,ROU,0,1,0,1,1936,2,0.002369668246445498
25,RSA,0,1,0,1,1936,2,0.002369668246445498
25,YUG,0,1,0,1,1936,2,0.002369668246445498
28,BEL,0,0,3,3,1936,3,0.0071090047393364926
28,MEX,0,0,3,3,1936,3,0.0071090047393364926
30,AUS,0,0,1,1,1936,1,0.002369668246445498
30,PHI,0,0,1,1,1936,1,0.002369668246445498
30,POR,0,0,1,1,1936,1,0.002369668246445498
1,USA,38,27,19,84,1948,187,0.20437956204379562
2,SWE,16,11,17,44,1948,87,0.1070559610705596
3,FRA,10,6,13,29,1948,55,0.0705596107055961
4,HUN,10,5,12,27,1948,52,0.06569343065693431
5,ITA,8,11,8,27,1948,54,0.06569343065693431
6,FIN,8,7,5,20,1948,43,0.04866180048661801
7,TUR,6,4,2,12,1948,28,0.029197080291970802
8,TCH,6,2,3,11,1948,25,0.0267639902676399
9,SUI,5,10,5,20,1948,40,0.04866180048661801
10,DEN,5,7,8,20,1948,37,0.04866180048661801
11,NED,5,2,9,16,1948,28,0.038929440389294405
12,GBR,3,14,6,23,1948,43,0.05596107055961071
13,ARG,3,3,1,7,1948,16,0.0170316301703163
14,AUS,2,6,5,13,1948,23,0.031630170316301706
15,BEL,2,2,3,7,1948,13,0.0170316301703163
16,EGY,2,2,1,5,1948,11,0.012165450121654502
17,MEX,2,1,2,5,1948,10,0.012165450121654502
18,RSA,2,1,1,4,1948,9,0.009732360097323601
19,NOR,1,3,3,7,1948,12,0.0170316301703163
20,JAM,1,2,0,3,1948,7,0.0072992700729927005
21,AUT,1,0,3,4,1948,6,0.009732360097323601
22,IND,1,0,0,1,1948,3,0.0024330900243309003
22,PER,1,0,0,1,1948,3,0.0024330900243309003
24,YUG,0,2,0,2,1948,4,0.004866180048661801
25,CAN,0,1,2,3,1948,4,0.0072992700729927005
26,POR,0,1,1,2,1948,3,0.004866180048661801
26,URU,0,1,1,2,1948,3,0.004866180048661801
28,CEY,0,1,0,1,1948,2,0.0024330900243309003
28,CUB,0,1,0,1,1948,2,0.0024330900243309003
28,ESP,0,1,0,1,1948,2,0.0024330900243309003
28,TTO,0,1,0,1,1948,2,0.0024330900243309003
32,PAN,0,0,2,2,1948,2,0.004866180048661801
32,KOR,0,0,2,2,1948,2,0.004866180048661801
34,BRA,0,0,1,1,1948,1,0.0024330900243309003
34,IRI,0,0,1,1,1948,1,0.0024330900243309003
34,POL,0,0,1,1,1948,1,0.0024330900243309003
34,PUR,0,0,1,1,1948,1,0.0024330900243309003
1,USA,40,19,17,76,1952,175,0.1655773420479303
2,URS,22,30,19,71,1952,145,0.15468409586056645
3,HUN,16,10,16,42,1952,84,0.0915032679738562
4,SWE,12,13,10,35,1952,72,0.07625272331154684
5,ITA,8,9,4,21,1952,46,0.0457516339869281
6,TCH,7,3,3,13,1952,30,0.02832244008714597
7,FRA,6,6,6,18,1952,36,0.0392156862745098
8,FIN,6,3,13,22,1952,37,0.04793028322440087
9,AUS,6,2,3,11,1952,25,0.023965141612200435
10,NOR,3,2,0,5,1952,13,0.010893246187363835
11,SUI,2,6,6,14,1952,24,0.030501089324618737
12,RSA,2,4,4,10,1952,18,0.02178649237472767
13,JAM,2,3,0,5,1952,12,0.010893246187363835
14,BEL,2,2,0,4,1952,10,0.008714596949891068
15,DEN,2,1,3,6,1952,11,0.013071895424836602
16,TUR,2,0,1,3,1952,7,0.006535947712418301
17,JPN,1,6,2,9,1952,17,0.0196078431372549
18,GBR,1,2,8,11,1952,15,0.023965141612200435
19,ARG,1,2,2,5,1952,9,0.010893246187363835
20,POL,1,2,1,4,1952,8,0.008714596949891068
21,CAN,1,2,0,3,1952,7,0.006535947712418301
21,YUG,1,2,0,3,1952,7,0.006535947712418301
23,ROU,1,1,2,4,1952,7,0.008714596949891068
24,BRA,1,0,2,3,1952,5,0.006535947712418301
24,NZL,1,0,2,3,1952,5,0.006535947712418301
26,IND,1,0,1,2,1952,4,0.004357298474945534
27,LUX,1,0,0,1,1952,3,0.002178649237472767
28,GER,0,7,17,24,1952,31,0.05228758169934641
29,NED,0,5,0,5,1952,10,0.010893246187363835
30,IRI,0,3,4,7,1952,10,0.015250544662309368
31,CHI,0,2,0,2,1952,4,0.004357298474945534
32,AUT,0,1,1,2,1952,3,0.004357298474945534
32,LIB,0,1,1,2,1952,3,0.004357298474945534
34,IRL,0,1,0,1,1952,2,0.002178649237472767
34,MEX,0,1,0,1,1952,2,0.002178649237472767
34,ESP,0,1,0,1,1952,2,0.002178649237472767
37,KOR,0,0,2,2,1952,2,0.004357298474945534
37,TTO,0,0,2,2,1952,2,0.004357298474945534
37,URU,0,0,2,2,1952,2,0.004357298474945534
40,BUL,0,0,1,1,1952,1,0.002178649237472767
40,EGY,0,0,1,1,1952,1,0.002178649237472767
40,POR,0,0,1,1,1952,1,0.002178649237472767
40,VEN,0,0,1,1,1952,1,0.002178649237472767
1,URS,37,29,32,98,1956,201,0.208955223880597
2,USA,32,25,17,74,1956,163,0.15778251599147122
3,AUS,13,8,14,35,1956,69,0.07462686567164178
4,HUN,9,10,7,26,1956,54,0.05543710021321962
5,ITA,8,8,9,25,1956,49,0.053304904051172705
6,SWE,8,5,6,19,1956,40,0.04051172707889126
7,EUN,6,13,7,26,1956,51,0.05543710021321962
8,GBR,6,7,11,24,1956,43,0.0511727078891258
9,ROU,5,3,5,13,1956,26,0.02771855010660981
10,JPN,4,10,5,19,1956,37,0.04051172707889126
11,FRA,4,4,6,14,1956,26,0.029850746268656716
12,TUR,3,2,2,7,1956,15,0.014925373134328358
13,FIN,3,1,11,15,1956,22,0.031982942430703626
14,IRI,2,2,1,5,1956,11,0.010660980810234541
15,CAN,2,1,3,6,1956,11,0.01279317697228145
16,NZL,2,0,0,2,1956,6,0.0042643923240938165
17,POL,1,4,4,9,1956,15,0.019189765458422176
18,TCH,1,4,1,6,1956,12,0.01279317697228145
19,BUL,1,3,1,5,1956,10,0.010660980810234541
20,DEN,1,2,1,4,1956,8,0.008528784648187633
21,IRL,1,1,3,5,1956,8,0.010660980810234541
22,NOR,1,0,2,3,1956,5,0.006396588486140725
23,MEX,1,0,1,2,1956,4,0.0042643923240938165
24,BRA,1,0,0,1,1956,3,0.0021321961620469083
24,IND,1,0,0,1,1956,3,0.0021321961620469083
26,YUG,0,3,0,3,1956,6,0.006396588486140725
27,CHI,0,2,2,4,1956,6,0.008528784648187633
28,BEL,0,2,0,2,1956,4,0.0042643923240938165
29,ARG,0,1,1,2,1956,3,0.0042643923240938165
29,KOR,0,1,1,2,1956,3,0.0042643923240938165
31,ISL,0,1,0,1,1956,2,0.0021321961620469083
31,PAK,0,1,0,1,1956,2,0.0021321961620469083
33,RSA,0,0,4,4,1956,4,0.008528784648187633
34,AUT,0,0,2,2,1956,2,0.0042643923240938165
35,BAH,0,0,1,1,1956,1,0.0021321961620469083
35,GRE,0,0,1,1,1956,1,0.0021321961620469083
35,SUI,0,0,1,1,1956,1,0.0021321961620469083
35,URU,0,0,1,1,1956,1,0.0021321961620469083
1,URS,43,29,31,103,1960,218,0.22342733188720174
2,USA,34,21,16,71,1960,160,0.1540130151843818
3,ITA,13,10,13,36,1960,72,0.07809110629067245
4,EUN,12,19,11,42,1960,85,0.0911062906724512
5,AUS,8,8,6,22,1960,46,0.04772234273318872
6,TUR,7,2,0,9,1960,25,0.019522776572668113
7,HUN,6,8,7,21,1960,41,0.0455531453362256
8,JPN,4,7,7,18,1960,33,0.039045553145336226
9,POL,4,6,11,21,1960,35,0.0455531453362256
10,TCH,3,2,3,8,1960,16,0.01735357917570499
11,ROU,3,1,6,10,1960,17,0.021691973969631236
12,GBR,2,6,12,20,1960,30,0.04338394793926247
13,DEN,2,3,1,6,1960,13,0.013015184381778741
14,NZL,2,0,1,3,1960,7,0.006507592190889371
15,BUL,1,3,3,7,1960,12,0.015184381778741865
16,SWE,1,2,3,6,1960,10,0.013015184381778741
17,FIN,1,1,3,5,1960,8,0.010845986984815618
18,AUT,1,1,0,2,1960,5,0.004338394793926247
18,YUG,1,1,0,2,1960,5,0.004338394793926247
20,PAK,1,0,1,2,1960,4,0.004338394793926247
21,ETH,1,0,0,1,1960,3,0.0021691973969631237
21,GRE,1,0,0,1,1960,3,0.0021691973969631237
21,NOR,1,0,0,1,1960,3,0.0021691973969631237
24,SUI,0,3,3,6,1960,9,0.013015184381778741
25,FRA,0,2,3,5,1960,7,0.010845986984815618
26,BEL,0,2,2,4,1960,6,0.008676789587852495
27,IRI,0,1,3,4,1960,5,0.008676789587852495
28,NED,0,1,2,3,1960,4,0.006507592190889371
28,RSA,0,1,2,3,1960,4,0.006507592190889371
30,ARG,0,1,1,2,1960,3,0.004338394793926247
30,EGY,0,1,1,2,1960,3,0.004338394793926247
32,CAN,0,1,0,1,1960,2,0.0021691973969631237
32,TPE,0,1,0,1,1960,2,0.0021691973969631237
32,GHA,0,1,0,1,1960,2,0.0021691973969631237
32,IND,0,1,0,1,1960,2,0.0021691973969631237
32,MAR,0,1,0,1,1960,2,0.0021691973969631237
32,POR,0,1,0,1,1960,2,0.0021691973969631237
32,SGP,0,1,0,1,1960,2,0.0021691973969631237
39,BRA,0,0,2,2,1960,2,0.004338394793926247
39,BWI,0,0,2,2,1960,2,0.004338394793926247
41,IRQ,0,0,1,1,1960,1,0.0021691973969631237
41,MEX,0,0,1,1,1960,1,0.0021691973969631237
41,ESP,0,0,1,1,1960,1,0.0021691973969631237
41,VEN,0,0,1,1,1960,1,0.0021691973969631237
1,USA,36,26,28,90,1964,188,0.17857142857142858
2,URS,30,31,35,96,1964,187,0.19047619047619047
3,JPN,16,5,8,29,1964,66,0.057539682539682536
4,EUN,10,22,18,50,1964,92,0.0992063492063492
5,ITA,10,10,7,27,1964,57,0.05357142857142857
6,HUN,10,7,5,22,1964,49,0.04365079365079365
7,POL,7,6,10,23,1964,43,0.04563492063492063
8,AUS,6,2,10,18,1964,32,0.03571428571428571
9,TCH,5,6,3,14,1964,30,0.027777777777777776
10,GBR,4,12,2,18,1964,38,0.03571428571428571
11,BUL,3,5,2,10,1964,21,0.01984126984126984
12,FIN,3,0,2,5,1964,11,0.00992063492063492
12,NZL,3,0,2,5,1964,11,0.00992063492063492
14,ROU,2,4,6,12,1964,20,0.023809523809523808
15,NED,2,4,4,10,1964,18,0.01984126984126984
16,TUR,2,3,1,6,1964,13,0.011904761904761904
17,SWE,2,2,4,8,1964,14,0.015873015873015872
18,DEN,2,1,3,6,1964,11,0.011904761904761904
19,YUG,2,1,2,5,1964,10,0.00992063492063492
20,BEL,2,0,1,3,1964,7,0.005952380952380952
21,FRA,1,8,6,15,1964,25,0.02976190476190476
22,CAN,1,2,1,4,1964,8,0.007936507936507936
22,SUI,1,2,1,4,1964,8,0.007936507936507936
24,BAH,1,0,0,1,1964,3,0.001984126984126984
24,ETH,1,0,0,1,1964,3,0.001984126984126984
24,IND,1,0,0,1,1964,3,0.001984126984126984
27,KOR,0,2,1,3,1964,5,0.005952380952380952
28,TTO,0,1,2,3,1964,4,0.005952380952380952
29,TUN,0,1,1,2,1964,3,0.003968253968253968
30,ARG,0,1,0,1,1964,2,0.001984126984126984
30,CUB,0,1,0,1,1964,2,0.001984126984126984
30,PAK,0,1,0,1,1964,2,0.001984126984126984
30,PHI,0,1,0,1,1964,2,0.001984126984126984
34,IRI,0,0,2,2,1964,2,0.003968253968253968
35,BRA,0,0,1,1,1964,1,0.001984126984126984
35,Ghana,0,0,1,1,1964,1,0.001984126984126984
35,IRL,0,0,1,1,1964,1,0.001984126984126984
35,KEN,0,0,1,1,1964,1,0.001984126984126984
35,MEX,0,0,1,1,1964,1,0.001984126984126984
35,NGR,0,0,1,1,1964,1,0.001984126984126984
35,URU,0,0,1,1,1964,1,0.001984126984126984
1,USA,45,28,34,107,1968,225,0.2030360531309298
2,URS,29,32,30,91,1968,181,0.17267552182163187
3,JPN,11,7,7,25,1968,54,0.04743833017077799
4,HUN,10,10,12,32,1968,62,0.06072106261859583
5,GDR,9,9,7,25,1968,52,0.04743833017077799
6,FRA,7,3,5,15,1968,32,0.028462998102466792
7,TCH,7,2,4,13,1968,29,0.024667931688804556
8,FRG,5,11,10,26,1968,47,0.04933586337760911
9,AUS,5,7,5,17,1968,34,0.03225806451612903
10,GBR,5,5,3,13,1968,28,0.024667931688804556
11,POL,5,2,11,18,1968,30,0.03415559772296015
12,ROU,4,6,5,15,1968,29,0.028462998102466792
13,ITA,3,4,9,16,1968,26,0.030360531309297913
14,KEN,3,4,2,9,1968,19,0.017077798861480076
15,MEX,3,3,3,9,1968,18,0.017077798861480076
16,YUG,3,3,2,8,1968,17,0.015180265654648957
17,NED,3,3,1,7,1968,16,0.013282732447817837
18,BUL,2,4,3,9,1968,17,0.017077798861480076
19,IRI,2,1,2,5,1968,10,0.009487666034155597
20,SWE,2,1,1,4,1968,9,0.007590132827324478
21,TUR,2,0,0,2,1968,6,0.003795066413662239
22,DEN,1,4,3,8,1968,14,0.015180265654648957
23,CAN,1,3,1,5,1968,10,0.009487666034155597
24,FIN,1,2,1,4,1968,8,0.007590132827324478
25,ETH,1,1,0,2,1968,5,0.003795066413662239
25,NOR,1,1,0,2,1968,5,0.003795066413662239
27,NZL,1,0,2,3,1968,5,0.0056925996204933585
28,TUN,1,0,1,2,1968,4,0.003795066413662239
29,PAK,1,0,0,1,1968,3,0.0018975332068311196
29,VEN,1,0,0,1,1968,3,0.0018975332068311196
31,CUB,0,4,0,4,1968,8,0.007590132827324478
32,AUT,0,2,2,4,1968,6,0.007590132827324478
33,SUI,0,1,4,5,1968,6,0.009487666034155597
34,MGL,0,1,3,4,1968,5,0.007590132827324478
35,BRA,0,1,2,3,1968,4,0.0056925996204933585
36,BEL,0,1,1,2,1968,3,0.003795066413662239
36,KOR,0,1,1,2,1968,3,0.003795066413662239
36,UGA,0,1,1,2,1968,3,0.003795066413662239
39,CMR,0,1,0,1,1968,2,0.0018975332068311196
39,JAM,0,1,0,1,1968,2,0.0018975332068311196
41,ARG,0,0,2,2,1968,2,0.003795066413662239
42,GRE,0,0,1,1,1968,1,0.0018975332068311196
42,IND,0,0,1,1,1968,1,0.0018975332068311196
42,TPE,0,0,1,1,1968,1,0.0018975332068311196
1,URS,50,27,22,99,1972,226,0.165
2,USA,33,31,30,94,1972,191,0.15666666666666668
3,GDR,20,23,23,66,1972,129,0.11
4,FRG,13,11,16,40,1972,77,0.06666666666666667
5,JPN,13,8,8,29,1972,63,0.04833333333333333
6,AUS,8,7,2,17,1972,40,0.028333333333333332
7,POL,7,5,9,21,1972,40,0.035
8,HUN,6,13,16,35,1972,60,0.058333333333333334
9,BUL,6,10,5,21,1972,43,0.035
10,ITA,5,3,10,18,1972,31,0.03
11,SWE,4,6,6,16,1972,30,0.02666666666666667
12,GBR,4,5,9,18,1972,31,0.03
13,ROU,3,6,7,16,1972,28,0.02666666666666667
14,CUB,3,1,4,8,1972,15,0.013333333333333334
14,FIN,3,1,4,8,1972,15,0.013333333333333334
16,NED,3,1,1,5,1972,12,0.008333333333333333
17,FRA,2,4,7,13,1972,21,0.021666666666666667
18,TCH,2,4,2,8,1972,16,0.013333333333333334
19,KEN,2,3,4,9,1972,16,0.015
20,YUG,2,1,2,5,1972,10,0.008333333333333333
21,NOR,2,1,1,4,1972,9,0.006666666666666667
22,PRK,1,1,3,5,1972,8,0.008333333333333333
23,NZL,1,1,1,3,1972,6,0.005
24,UGA,1,1,0,2,1972,5,0.0033333333333333335
25,DEN,1,0,0,1,1972,3,0.0016666666666666668
26,SUI,0,3,0,3,1972,6,0.005
27,CAN,0,2,3,5,1972,7,0.008333333333333333
28,IRI,0,2,1,3,1972,5,0.005
29,BEL,0,2,0,2,1972,4,0.0033333333333333335
29,GRE,0,2,0,2,1972,4,0.0033333333333333335
31,AUT,0,1,2,3,1972,4,0.005
31,COL,0,1,2,3,1972,4,0.005
33,ARG,0,1,0,1,1972,2,0.0016666666666666668
33,LIB,0,1,0,1,1972,2,0.0016666666666666668
33,MEX,0,1,0,1,1972,2,0.0016666666666666668
33,MGL,0,1,0,1,1972,2,0.0016666666666666668
33,PAK,0,1,0,1,1972,2,0.0016666666666666668
33,KOR,0,1,0,1,1972,2,0.0016666666666666668
33,TUN,0,1,0,1,1972,2,0.0016666666666666668
33,TUR,0,1,0,1,1972,2,0.0016666666666666668
41,BRA,0,0,2,2,1972,2,0.0033333333333333335
41,ETH,0,0,2,2,1972,2,0.0033333333333333335
43,Ghana,0,0,1,1,1972,1,0.0016666666666666668
43,IND,0,0,1,1,1972,1,0.0016666666666666668
43,JAM,0,0,1,1,1972,1,0.0016666666666666668
43,NIG,0,0,1,1,1972,1,0.0016666666666666668
43,NGR,0,0,1,1,1972,1,0.0016666666666666668
43,ESP,0,0,1,1,1972,1,0.0016666666666666668
1,URS,49,41,35,125,1976,264,0.2039151712887439
2,GDR,40,25,25,90,1976,195,0.1468189233278956
3,USA,34,35,25,94,1976,197,0.1533442088091354
4,FRG,10,12,17,39,1976,71,0.0636215334420881
5,JPN,9,6,10,25,1976,49,0.040783034257748776
6,POL,7,6,13,26,1976,46,0.04241435562805873
7,BUL,6,9,7,22,1976,43,0.03588907014681892
8,CUB,6,4,3,13,1976,29,0.021207177814029365
9,ROU,4,9,14,27,1976,44,0.04404567699836868
10,HUN,4,5,13,22,1976,35,0.03588907014681892
11,FIN,4,2,0,6,1976,16,0.009787928221859706
12,SWE,4,1,0,5,1976,14,0.008156606851549755
13,GBR,3,5,5,13,1976,24,0.021207177814029365
14,ITA,2,7,4,13,1976,24,0.021207177814029365
15,FRA,2,3,4,9,1976,16,0.01468189233278956
16,YUG,2,3,3,8,1976,15,0.013050570962479609
17,TCH,2,2,4,8,1976,14,0.013050570962479609
18,NZL,2,1,1,4,1976,9,0.0065252854812398045
19,KOR,1,1,4,6,1976,9,0.009787928221859706
20,SUI,1,1,2,4,1976,7,0.0065252854812398045
21,JAM,1,1,0,2,1976,5,0.0032626427406199023
21,PRK,1,1,0,2,1976,5,0.0032626427406199023
21,NOR,1,1,0,2,1976,5,0.0032626427406199023
24,DEN,1,0,2,3,1976,5,0.004893964110929853
25,MEX,1,0,1,2,1976,4,0.0032626427406199023
26,TTO,1,0,0,1,1976,3,0.0016313213703099511
27,CAN,0,5,6,11,1976,16,0.01794453507340946
28,BEL,0,3,3,6,1976,9,0.009787928221859706
29,NED,0,2,3,5,1976,7,0.008156606851549755
30,POR,0,2,0,2,1976,4,0.0032626427406199023
30,ESP,0,2,0,2,1976,4,0.0032626427406199023
32,AUS,0,1,4,5,1976,6,0.008156606851549755
33,IRI,0,1,1,2,1976,3,0.0032626427406199023
34,MGL,0,1,0,1,1976,2,0.0016313213703099511
34,VEN,0,1,0,1,1976,2,0.0016313213703099511
36,BRA,0,0,2,2,1976,2,0.0032626427406199023
37,AUT,0,0,1,1,1976,1,0.0016313213703099511
37,BER,0,0,1,1,1976,1,0.0016313213703099511
37,PAK,0,0,1,1,1976,1,0.0016313213703099511
37,PUR,0,0,1,1,1976,1,0.0016313213703099511
37,THA,0,0,1,1,1976,1,0.0016313213703099511
1,URS,80,69,46,195,1980,424,0.3090332805071315
2,GDR,47,37,42,126,1980,257,0.19968304278922344
3,BUL,8,16,17,41,1980,73,0.06497622820919176
4,CUB,8,7,5,20,1980,43,0.03169572107765452
5,ITA,8,3,4,15,1980,34,0.02377179080824089
6,HUN,7,10,15,32,1980,56,0.05071315372424723
7,ROU,6,6,13,25,1980,43,0.039619651347068144
8,FRA,6,5,3,14,1980,31,0.022187004754358162
9,GBR,5,7,9,21,1980,38,0.03328050713153724
10,POL,3,14,15,32,1980,52,0.05071315372424723
11,SWE,3,3,6,12,1980,21,0.01901743264659271
12,FIN,3,1,4,8,1980,15,0.012678288431061807
13,TCH,2,3,9,14,1980,21,0.022187004754358162
14,YUG,2,3,4,9,1980,16,0.014263074484944533
15,AUS,2,2,5,9,1980,15,0.014263074484944533
16,DEN,2,1,2,5,1980,10,0.00792393026941363
17,BRA,2,0,2,4,1980,8,0.006339144215530904
17,ETH,2,0,2,4,1980,8,0.006339144215530904
19,SUI,2,0,0,2,1980,6,0.003169572107765452
20,ESP,1,3,2,6,1980,11,0.009508716323296355
21,AUT,1,2,1,4,1980,8,0.006339144215530904
22,GRE,1,0,2,3,1980,5,0.004754358161648178
23,BEL,1,0,0,1,1980,3,0.001584786053882726
23,IND,1,0,0,1,1980,3,0.001584786053882726
23,ZIM,1,0,0,1,1980,3,0.001584786053882726
26,PRK,0,3,2,5,1980,8,0.00792393026941363
27,MGL,0,2,2,4,1980,6,0.006339144215530904
28,TAN,0,2,0,2,1980,4,0.003169572107765452
29,MEX,0,1,3,4,1980,5,0.006339144215530904
30,NED,0,1,2,3,1980,4,0.004754358161648178
31,IRL,0,1,1,2,1980,3,0.003169572107765452
32,UGA,0,1,0,1,1980,2,0.001584786053882726
32,VEN,0,1,0,1,1980,2,0.001584786053882726
34,JAM,0,0,3,3,1980,3,0.004754358161648178
35,GUY,0,0,1,1,1980,1,0.001584786053882726
35,LIB,0,0,1,1,1980,1,0.001584786053882726
1,USA,83,61,30,174,1984,401,0.25290697674418605
2,ROU,20,16,17,53,1984,109,0.07703488372093023
3,FRG,17,19,23,59,1984,112,0.08575581395348837
4,CHN,15,8,9,32,1984,70,0.046511627906976744
5,ITA,14,6,12,32,1984,66,0.046511627906976744
6,CAN,10,18,16,44,1984,82,0.06395348837209303
7,JPN,10,8,14,32,1984,60,0.046511627906976744
8,NZL,8,1,2,11,1984,28,0.015988372093023256
9,YUG,7,4,7,18,1984,36,0.02616279069767442
10,KOR,6,6,7,19,1984,37,0.027616279069767442
11,GBR,5,11,21,37,1984,58,0.05377906976744186
12,FRA,5,7,16,28,1984,45,0.040697674418604654
13,NED,5,2,6,13,1984,25,0.0188953488372093
14,AUS,4,8,12,24,1984,40,0.03488372093023256
15,FIN,4,2,6,12,1984,22,0.01744186046511628
16,SWE,2,11,6,19,1984,34,0.027616279069767442
17,MEX,2,3,1,6,1984,13,0.00872093023255814
18,MAR,2,0,0,2,1984,6,0.0029069767441860465
19,BRA,1,5,2,8,1984,15,0.011627906976744186
20,ESP,1,2,2,5,1984,9,0.007267441860465116
21,BEL,1,1,2,4,1984,7,0.005813953488372093
22,AUT,1,1,1,3,1984,6,0.00436046511627907
23,KEN,1,0,2,3,1984,5,0.00436046511627907
23,POR,1,0,2,3,1984,5,0.00436046511627907
25,PAK,1,0,0,1,1984,3,0.0014534883720930232
26,SUI,0,4,4,8,1984,12,0.011627906976744186
27,DEN,0,3,3,6,1984,9,0.00872093023255814
28,JAM,0,1,2,3,1984,4,0.00436046511627907
28,NOR,0,1,2,3,1984,4,0.00436046511627907
30,GRE,0,1,1,2,1984,3,0.0029069767441860465
30,NGR,0,1,1,2,1984,3,0.0029069767441860465
30,PUR,0,1,1,2,1984,3,0.0029069767441860465
33,COL,0,1,0,1,1984,2,0.0014534883720930232
33,EGY,0,1,0,1,1984,2,0.0014534883720930232
33,IRL,0,1,0,1,1984,2,0.0014534883720930232
33,CIV,0,1,0,1,1984,2,0.0014534883720930232
33,PER,0,1,0,1,1984,2,0.0014534883720930232
33,SYR,0,1,0,1,1984,2,0.0014534883720930232
33,THA,0,1,0,1,1984,2,0.0014534883720930232
40,TUR,0,0,3,3,1984,3,0.00436046511627907
40,VEN,0,0,3,3,1984,3,0.00436046511627907
42,ALG,0,0,2,2,1984,2,0.0029069767441860465
43,CMR,0,0,1,1,1984,1,0.0014534883720930232
43,TPE,0,0,1,1,1984,1,0.0014534883720930232
43,DOM,0,0,1,1,1984,1,0.0014534883720930232
43,ISL,0,0,1,1,1984,1,0.0014534883720930232
43,ZAM,0,0,1,1,1984,1,0.0014534883720930232
1,URS,55,31,46,132,1988,273,0.17861975642760486
2,GDR,37,35,30,102,1988,211,0.13802435723951287
3,USA,36,31,27,94,1988,197,0.12719891745602166
4,KOR,12,10,11,33,1988,67,0.044654939106901215
5,FRG,11,14,15,40,1988,76,0.05412719891745602
6,HUN,11,6,6,23,1988,51,0.03112313937753721
7,BUL,10,12,13,35,1988,67,0.04736129905277402
8,ROU,7,11,6,24,1988,49,0.03247631935047361
9,FRA,6,4,6,16,1988,32,0.02165087956698241
10,ITA,6,4,4,14,1988,30,0.018944519621109608
11,CHN,5,11,12,28,1988,49,0.037889039242219216
12,GBR,5,10,9,24,1988,44,0.03247631935047361
13,KEN,5,2,2,9,1988,21,0.012178619756427604
14,JPN,4,3,7,14,1988,25,0.018944519621109608
15,AUS,3,6,5,14,1988,26,0.018944519621109608
16,YUG,3,4,5,12,1988,22,0.016238159675236806
17,TCH,3,3,2,8,1988,17,0.010825439783491205
18,NZL,3,2,8,13,1988,21,0.017591339648173207
19,CAN,3,2,5,10,1988,18,0.013531799729364006
20,POL,2,5,9,16,1988,25,0.02165087956698241
21,NOR,2,3,0,5,1988,12,0.006765899864682003
22,NED,2,2,5,9,1988,15,0.012178619756427604
23,DEN,2,1,1,4,1988,9,0.005412719891745603
24,BRA,1,2,3,6,1988,10,0.008119079837618403
25,FIN,1,1,2,4,1988,7,0.005412719891745603
25,ESP,1,1,2,4,1988,7,0.005412719891745603
27,TUR,1,1,0,2,1988,5,0.0027063599458728013
28,MAR,1,0,2,3,1988,5,0.0040595399188092015
29,AUT,1,0,0,1,1988,3,0.0013531799729364006
29,POR,1,0,0,1,1988,3,0.0013531799729364006
29,SUR,1,0,0,1,1988,3,0.0013531799729364006
32,SWE,0,4,7,11,1988,15,0.014884979702300407
33,SUI,0,2,2,4,1988,6,0.005412719891745603
34,JAM,0,2,0,2,1988,4,0.0027063599458728013
35,ARG,0,1,1,2,1988,3,0.0027063599458728013
36,CHI,0,1,0,1,1988,2,0.0013531799729364006
36,CRC,0,1,0,1,1988,2,0.0013531799729364006
36,INA,0,1,0,1,1988,2,0.0013531799729364006
36,IRI,0,1,0,1,1988,2,0.0013531799729364006
36,AHO,0,1,0,1,1988,2,0.0013531799729364006
36,PER,0,1,0,1,1988,2,0.0013531799729364006
36,SEN,0,1,0,1,1988,2,0.0013531799729364006
36,ISV,0,1,0,1,1988,2,0.0013531799729364006
44,BEL,0,0,2,2,1988,2,0.0027063599458728013
44,MEX,0,0,2,2,1988,2,0.0027063599458728013
46,COL,0,0,1,1,1988,1,0.0013531799729364006
46,DJI,0,0,1,1,1988,1,0.0013531799729364006
46,GRE,0,0,1,1,1988,1,0.0013531799729364006
46,MGL,0,0,1,1,1988,1,0.0013531799729364006
46,PAK,0,0,1,1,1988,1,0.0013531799729364006
46,PHI,0,0,1,1,1988,1,0.0013531799729364006
46,THA,0,0,1,1,1988,1,0.0013531799729364006
1,EUN,45,38,29,112,1992,240,0.1374233128834356
2,USA,37,34,37,108,1992,216,0.1325153374233129
3,GER,33,21,28,82,1992,169,0.10061349693251534
4,CHN,16,22,16,54,1992,108,0.06625766871165645
5,CUB,14,6,11,31,1992,65,0.03803680981595092
6,ESP,13,7,2,22,1992,55,0.026993865030674847
7,KOR,12,5,12,29,1992,58,0.03558282208588957
8,HUN,11,12,7,30,1992,64,0.03680981595092025
9,FRA,8,5,16,29,1992,50,0.03558282208588957
10,AUS,7,9,11,27,1992,50,0.033128834355828224
11,CAN,7,4,7,18,1992,36,0.022085889570552148
12,ITA,6,5,8,19,1992,36,0.023312883435582823
13,GBR,5,3,12,20,1992,33,0.024539877300613498
14,ROU,4,6,8,18,1992,32,0.022085889570552148
15,TCH,4,2,1,7,1992,17,0.008588957055214725
16,PRK,4,0,5,9,1992,17,0.011042944785276074
17,JPN,3,8,11,22,1992,36,0.026993865030674847
18,BUL,3,7,6,16,1992,29,0.0196319018404908
19,POL,3,6,10,19,1992,31,0.023312883435582823
20,NED,2,6,7,15,1992,25,0.018404907975460124
21,KEN,2,4,2,8,1992,16,0.0098159509202454
22,NOR,2,4,1,7,1992,15,0.008588957055214725
23,TUR,2,2,2,6,1992,12,0.007361963190184049
24,INA,2,2,1,5,1992,11,0.006134969325153374
25,BRA,2,1,0,3,1992,8,0.0036809815950920245
26,GRE,2,0,0,2,1992,6,0.00245398773006135
27,SWE,1,7,4,12,1992,21,0.014723926380368098
28,NZL,1,4,5,10,1992,16,0.012269938650306749
29,FIN,1,2,2,5,1992,9,0.006134969325153374
30,DEN,1,1,4,6,1992,9,0.007361963190184049
31,MAR,1,1,1,3,1992,6,0.0036809815950920245
32,IRL,1,1,0,2,1992,5,0.00245398773006135
33,ETH,1,0,2,3,1992,5,0.0036809815950920245
34,ALG,1,0,1,2,1992,4,0.00245398773006135
34,EST,1,0,1,2,1992,4,0.00245398773006135
34,LTU,1,0,1,2,1992,4,0.00245398773006135
37,SUI,1,0,0,1,1992,3,0.001226993865030675
38,JAM,0,3,1,4,1992,7,0.0049079754601227
38,NGR,0,3,1,4,1992,7,0.0049079754601227
40,LAT,0,2,1,3,1992,5,0.0036809815950920245
41,AUT,0,2,0,2,1992,4,0.00245398773006135
41,NAM,0,2,0,2,1992,4,0.00245398773006135
41,RSA,0,2,0,2,1992,4,0.00245398773006135
44,BEL,0,1,2,3,1992,4,0.0036809815950920245
44,CRO,0,1,2,3,1992,4,0.0036809815950920245
44,IOP,0,1,2,3,1992,4,0.0036809815950920245
44,IRI,0,1,2,3,1992,4,0.0036809815950920245
48,ISR,0,1,1,2,1992,3,0.00245398773006135
49,TPE,0,1,0,1,1992,2,0.001226993865030675
49,MEX,0,1,0,1,1992,2,0.001226993865030675
49,PER,0,1,0,1,1992,2,0.001226993865030675
52,MGL,0,0,2,2,1992,2,0.00245398773006135
52,SLO,0,0,2,2,1992,2,0.00245398773006135
54,ARG,0,0,1,1,1992,1,0.001226993865030675
54,BAH,0,0,1,1,1992,1,0.001226993865030675
54,COL,0,0,1,1,1992,1,0.001226993865030675
54,Ghana,0,0,1,1,1992,1,0.001226993865030675
54,MAS,0,0,1,1,1992,1,0.001226993865030675
54,PAK,0,0,1,1,1992,1,0.001226993865030675
54,PHI,0,0,1,1,1992,1,0.001226993865030675
54,PUR,0,0,1,1,1992,1,0.001226993865030675
54,QAT,0,0,1,1,1992,1,0.001226993865030675
54,SUR,0,0,1,1,1992,1,0.001226993865030675
54,THA,0,0,1,1,1992,1,0.001226993865030675
1,USA,44,32,25,101,1996,221,0.11995249406175772
2,RUS,26,21,16,63,1996,136,0.07482185273159145
3,GER,20,18,27,65,1996,123,0.07719714964370546
4,CHN,16,22,12,50,1996,104,0.05938242280285035
5,FRA,15,7,15,37,1996,74,0.043942992874109264
6,ITA,13,10,12,35,1996,71,0.04156769596199525
7,AUS,9,9,23,41,1996,68,0.048693586698337295
8,CUB,9,8,8,25,1996,51,0.029691211401425176
9,UKR,9,2,12,23,1996,43,0.027315914489311165
10,KOR,7,15,5,27,1996,56,0.032066508313539195
11,POL,7,5,5,17,1996,36,0.020190023752969122
12,HUN,7,4,10,21,1996,39,0.02494061757719715
13,ESP,5,6,6,17,1996,33,0.020190023752969122
14,ROU,4,7,9,20,1996,35,0.023752969121140142
15,NED,4,5,10,19,1996,32,0.022565320665083134
16,GRE,4,4,0,8,1996,20,0.009501187648456057
17,CZE,4,3,4,11,1996,22,0.013064133016627079
18,SUI,4,3,0,7,1996,18,0.00831353919239905
19,DEN,4,1,1,6,1996,15,0.007125890736342043
19,TUR,4,1,1,6,1996,15,0.007125890736342043
21,CAN,3,11,8,22,1996,39,0.026128266033254157
22,BUL,3,7,5,15,1996,28,0.017814726840855107
23,JPN,3,6,5,14,1996,26,0.0166270783847981
24,KAZ,3,4,4,11,1996,21,0.013064133016627079
25,BRA,3,3,9,15,1996,24,0.017814726840855107
26,NZL,3,2,1,6,1996,14,0.007125890736342043
27,RSA,3,1,1,5,1996,12,0.0059382422802850355
28,IRL,3,0,1,4,1996,10,0.004750593824228029
29,SWE,2,4,2,8,1996,16,0.009501187648456057
30,NOR,2,2,3,7,1996,13,0.00831353919239905
31,BEL,2,2,2,6,1996,12,0.007125890736342043
32,NGR,2,1,3,6,1996,11,0.007125890736342043
33,PRK,2,1,2,5,1996,10,0.0059382422802850355
34,ALG,2,0,1,3,1996,7,0.0035629453681710215
34,ETH,2,0,1,3,1996,7,0.0035629453681710215
36,GBR,1,8,6,15,1996,25,0.017814726840855107
37,BLR,1,6,8,15,1996,23,0.017814726840855107
38,KEN,1,4,3,8,1996,14,0.009501187648456057
39,JAM,1,3,2,6,1996,11,0.007125890736342043
40,FIN,1,2,1,4,1996,8,0.004750593824228029
41,FRY,1,1,2,4,1996,7,0.004750593824228029
41,INA,1,1,2,4,1996,7,0.004750593824228029
43,IRI,1,1,1,3,1996,6,0.0035629453681710215
43,SVK,1,1,1,3,1996,6,0.0035629453681710215
45,ARM,1,1,0,2,1996,5,0.0023752969121140144
45,CRO,1,1,0,2,1996,5,0.0023752969121140144
47,POR,1,0,1,2,1996,4,0.0023752969121140144
47,THA,1,0,1,2,1996,4,0.0023752969121140144
49,BDI,1,0,0,1,1996,3,0.0011876484560570072
49,CRC,1,0,0,1,1996,3,0.0011876484560570072
49,ECU,1,0,0,1,1996,3,0.0011876484560570072
49,HKG,1,0,0,1,1996,3,0.0011876484560570072
49,SYR,1,0,0,1,1996,3,0.0011876484560570072
54,ARG,0,2,1,3,1996,5,0.0035629453681710215
55,NAM,0,2,0,2,1996,4,0.0023752969121140144
55,SLO,0,2,0,2,1996,4,0.0023752969121140144
57,AUT,0,1,2,3,1996,4,0.0035629453681710215
58,MAS,0,1,1,2,1996,3,0.0023752969121140144
58,MDA,0,1,1,2,1996,3,0.0023752969121140144
58,UZB,0,1,1,2,1996,3,0.0023752969121140144
61,AZE,0,1,0,1,1996,2,0.0011876484560570072
61,BAH,0,1,0,1,1996,2,0.0011876484560570072
61,TPE,0,1,0,1,1996,2,0.0011876484560570072
61,LAT,0,1,0,1,1996,2,0.0011876484560570072
61,PHI,0,1,0,1,1996,2,0.0011876484560570072
61,TGA,0,1,0,1,1996,2,0.0011876484560570072
61,ZAM,0,1,0,1,1996,2,0.0011876484560570072
68,GEO,0,0,2,2,1996,2,0.0023752969121140144
68,MAR,0,0,2,2,1996,2,0.0023752969121140144
68,TTO,0,0,2,2,1996,2,0.0023752969121140144
71,IND,0,0,1,1,1996,1,0.0011876484560570072
71,ISR,0,0,1,1,1996,1,0.0011876484560570072
71,LTU,0,0,1,1,1996,1,0.0011876484560570072
71,MEX,0,0,1,1,1996,1,0.0011876484560570072
71,MGL,0,0,1,1,1996,1,0.0011876484560570072
71,MOZ,0,0,1,1,1996,1,0.0011876484560570072
71,PUR,0,0,1,1,1996,1,0.0011876484560570072
71,TUN,0,0,1,1,1996,1,0.0011876484560570072
71,UGA,0,0,1,1,1996,1,0.0011876484560570072
1,USA,37,24,32,93,2000,191,0.10032362459546926
2,RUS,32,28,29,89,2000,181,0.09600862998921252
3,CHN,28,16,14,58,2000,130,0.06256742179072276
4,AUS,16,25,17,58,2000,115,0.06256742179072276
5,GER,13,17,26,56,2000,99,0.06040992448759439
6,FRA,13,14,11,38,2000,78,0.040992448759439054
7,ITA,13,8,13,34,2000,68,0.036677454153182305
8,NED,12,9,4,25,2000,58,0.02696871628910464
9,CUB,11,11,7,29,2000,62,0.03128371089536138
10,GBR,11,10,7,28,2000,60,0.030204962243797196
11,ROU,11,6,9,26,2000,54,0.028047464940668825
12,KOR,8,10,10,28,2000,54,0.030204962243797196
13,HUN,8,6,3,17,2000,39,0.018338727076591153
14,POL,6,5,3,14,2000,31,0.015102481121898598
15,JPN,5,8,5,18,2000,36,0.019417475728155338
16,BUL,5,6,2,13,2000,29,0.014023732470334413
17,GRE,4,6,3,13,2000,27,0.014023732470334413
18,SWE,4,5,3,12,2000,25,0.012944983818770227
19,NOR,4,3,3,10,2000,21,0.010787486515641856
20,ETH,4,1,3,8,2000,17,0.008629989212513484
21,UKR,3,10,10,23,2000,39,0.02481121898597627
22,KAZ,3,4,0,7,2000,17,0.007551240560949299
23,BLR,3,3,11,17,2000,26,0.018338727076591153
24,CAN,3,3,8,14,2000,23,0.015102481121898598
25,ESP,3,3,5,11,2000,20,0.011866235167206042
26,TUR,3,0,2,5,2000,11,0.005393743257820928
27,IRI,3,0,1,4,2000,10,0.004314994606256742
28,CZE,2,3,3,8,2000,15,0.008629989212513484
29,KEN,2,3,2,7,2000,14,0.007551240560949299
30,DEN,2,3,1,6,2000,13,0.006472491909385114
31,FIN,2,1,1,4,2000,9,0.004314994606256742
32,AUT,2,1,0,3,2000,8,0.003236245954692557
33,LTU,2,0,3,5,2000,9,0.005393743257820928
34,AZE,2,0,1,3,2000,7,0.003236245954692557
34,BAH,2,0,1,3,2000,7,0.003236245954692557
36,SLO,2,0,0,2,2000,6,0.002157497303128371
37,SUI,1,6,2,9,2000,17,0.009708737864077669
38,INA,1,3,2,6,2000,11,0.006472491909385114
39,SVK,1,3,1,5,2000,10,0.005393743257820928
40,MEX,1,2,3,6,2000,10,0.006472491909385114
41,NGR,1,2,0,3,2000,7,0.003236245954692557
42,ALG,1,1,3,5,2000,8,0.005393743257820928
43,UZB,1,1,2,4,2000,7,0.004314994606256742
44,FRY,1,1,1,3,2000,6,0.003236245954692557
44,LAT,1,1,1,3,2000,6,0.003236245954692557
46,NZL,1,0,3,4,2000,6,0.004314994606256742
47,EST,1,0,2,3,2000,5,0.003236245954692557
47,THA,1,0,2,3,2000,5,0.003236245954692557
49,CRO,1,0,1,2,2000,4,0.002157497303128371
50,CMR,1,0,0,1,2000,3,0.0010787486515641855
50,COL,1,0,0,1,2000,3,0.0010787486515641855
50,MOZ,1,0,0,1,2000,3,0.0010787486515641855
53,BRA,0,6,6,12,2000,18,0.012944983818770227
54,JAM,0,6,3,9,2000,15,0.009708737864077669
55,BEL,0,2,3,5,2000,7,0.005393743257820928
55,RSA,0,2,3,5,2000,7,0.005393743257820928
57,ARG,0,2,2,4,2000,6,0.004314994606256742
58,TPE,0,1,4,5,2000,6,0.005393743257820928
58,MAR,0,1,4,5,2000,6,0.005393743257820928
60,PRK,0,1,3,4,2000,5,0.004314994606256742
61,MDA,0,1,1,2,2000,3,0.002157497303128371
61,KSA,0,1,1,2,2000,3,0.002157497303128371
61,TTO,0,1,1,2,2000,3,0.002157497303128371
64,IRL,0,1,0,1,2000,2,0.0010787486515641855
64,SRI,0,1,0,1,2000,2,0.0010787486515641855
64,URU,0,1,0,1,2000,2,0.0010787486515641855
64,VIE,0,1,0,1,2000,2,0.0010787486515641855
68,GEO,0,0,6,6,2000,6,0.006472491909385114
69,CRC,0,0,2,2,2000,2,0.002157497303128371
69,POR,0,0,2,2,2000,2,0.002157497303128371
71,ARM,0,0,1,1,2000,1,0.0010787486515641855
71,BAR,0,0,1,1,2000,1,0.0010787486515641855
71,CHI,0,0,1,1,2000,1,0.0010787486515641855
71,ISL,0,0,1,1,2000,1,0.0010787486515641855
71,IND,0,0,1,1,2000,1,0.0010787486515641855
71,ISR,0,0,1,1,2000,1,0.0010787486515641855
71,KUW,0,0,1,1,2000,1,0.0010787486515641855
71,KGZ,0,0,1,1,2000,1,0.0010787486515641855
71,MKD,0,0,1,1,2000,1,0.0010787486515641855
71,QAT,0,0,1,1,2000,1,0.0010787486515641855
1,USA,36,39,26,101,2004,212,0.10907127429805616
2,CHN,32,17,14,63,2004,144,0.06803455723542116
3,RUS,28,26,36,90,2004,172,0.09719222462203024
4,AUS,17,16,17,50,2004,100,0.05399568034557235
5,JPN,16,9,12,37,2004,78,0.03995680345572354
6,GER,13,16,20,49,2004,91,0.052915766738660906
7,FRA,11,9,13,33,2004,64,0.035637149028077755
8,ITA,10,11,11,32,2004,63,0.03455723542116631
9,KOR,9,12,9,30,2004,60,0.032397408207343416
10,GBR,9,9,12,30,2004,57,0.032397408207343416
11,CUB,9,7,11,27,2004,52,0.029157667386609073
12,HUN,8,6,3,17,2004,39,0.0183585313174946
13,UKR,8,5,9,22,2004,43,0.023758099352051837
14,ROU,8,5,6,19,2004,40,0.020518358531317494
15,GRE,6,6,4,16,2004,34,0.017278617710583154
16,BRA,5,2,3,10,2004,22,0.01079913606911447
17,NOR,5,0,1,6,2004,16,0.0064794816414686825
18,NED,4,9,9,22,2004,39,0.023758099352051837
19,SWE,4,2,1,7,2004,17,0.00755939524838013
20,ESP,3,11,6,20,2004,37,0.02159827213822894
21,CAN,3,6,3,12,2004,24,0.012958963282937365
22,TUR,3,3,4,10,2004,19,0.01079913606911447
23,POL,3,2,5,10,2004,18,0.01079913606911447
24,NZL,3,2,0,5,2004,13,0.005399568034557235
25,THA,3,1,4,8,2004,15,0.008639308855291577
26,BLR,2,5,6,13,2004,22,0.014038876889848811
27,AUT,2,4,1,7,2004,15,0.00755939524838013
28,ETH,2,3,2,7,2004,14,0.00755939524838013
29,IRI,2,2,2,6,2004,12,0.0064794816414686825
29,SVK,2,2,2,6,2004,12,0.0064794816414686825
31,TPE,2,2,1,5,2004,11,0.005399568034557235
32,GEO,2,2,0,4,2004,10,0.004319654427645789
33,BUL,2,1,9,12,2004,17,0.012958963282937365
34,DEN,2,1,5,8,2004,13,0.008639308855291577
35,JAM,2,1,2,5,2004,10,0.005399568034557235
35,UZB,2,1,2,5,2004,10,0.005399568034557235
37,MAR,2,1,0,3,2004,8,0.0032397408207343412
38,ARG,2,0,4,6,2004,10,0.0064794816414686825
39,CHI,2,0,1,3,2004,7,0.0032397408207343412
40,KAZ,1,4,3,8,2004,14,0.008639308855291577
41,KEN,1,4,2,7,2004,13,0.00755939524838013
42,CZE,1,3,5,9,2004,14,0.009719222462203024
43,RSA,1,3,2,6,2004,11,0.0064794816414686825
44,CRO,1,2,2,5,2004,9,0.005399568034557235
45,LTU,1,2,0,3,2004,7,0.0032397408207343412
46,EGY,1,1,3,5,2004,8,0.005399568034557235
46,SUI,1,1,3,5,2004,8,0.005399568034557235
48,INA,1,1,2,4,2004,7,0.004319654427645789
49,ZIM,1,1,1,3,2004,6,0.0032397408207343412
50,AZE,1,0,4,5,2004,7,0.005399568034557235
51,BEL,1,0,2,3,2004,5,0.0032397408207343412
52,BAH,1,0,1,2,2004,4,0.0021598272138228943
52,ISR,1,0,1,2,2004,4,0.0021598272138228943
54,CMR,1,0,0,1,2004,3,0.0010799136069114472
54,DOM,1,0,0,1,2004,3,0.0010799136069114472
54,UAE,1,0,0,1,2004,3,0.0010799136069114472
57,PRK,0,4,1,5,2004,9,0.005399568034557235
58,LAT,0,4,0,4,2004,8,0.004319654427645789
59,MEX,0,3,1,4,2004,7,0.004319654427645789
60,POR,0,2,1,3,2004,5,0.0032397408207343412
61,FIN,0,2,0,2,2004,4,0.0021598272138228943
61,SCG,0,2,0,2,2004,4,0.0021598272138228943
63,SLO,0,1,3,4,2004,5,0.004319654427645789
64,EST,0,1,2,3,2004,4,0.0032397408207343412
65,HKG,0,1,0,1,2004,2,0.0010799136069114472
65,IND,0,1,0,1,2004,2,0.0010799136069114472
65,PAR,0,1,0,1,2004,2,0.0010799136069114472
68,COL,0,0,2,2,2004,2,0.0021598272138228943
68,NGR,0,0,2,2,2004,2,0.0021598272138228943
68,VEN,0,0,2,2,2004,2,0.0021598272138228943
71,ERI,0,0,1,1,2004,1,0.0010799136069114472
71,MGL,0,0,1,1,2004,1,0.0010799136069114472
71,SYR,0,0,1,1,2004,1,0.0010799136069114472
71,TTO,0,0,1,1,2004,1,0.0010799136069114472
1,CHN,48,22,30,100,2008,218,0.10438413361169102
2,USA,36,39,37,112,2008,223,0.11691022964509394
3,RUS,24,13,23,60,2008,121,0.06263048016701461
4,GBR,19,13,19,51,2008,102,0.05323590814196242
5,GER,16,11,14,41,2008,84,0.04279749478079332
6,AUS,14,15,17,46,2008,89,0.04801670146137787
7,KOR,13,11,8,32,2008,69,0.033402922755741124
8,JPN,9,8,8,25,2008,51,0.026096033402922755
9,ITA,8,9,10,27,2008,52,0.028183716075156576
10,FRA,7,16,20,43,2008,73,0.04488517745302714
11,NED,7,5,4,16,2008,35,0.016701461377870562
12,UKR,7,4,11,22,2008,40,0.022964509394572025
13,KEN,6,4,6,16,2008,32,0.016701461377870562
14,ESP,5,11,3,19,2008,40,0.019832985386221295
15,JAM,5,4,2,11,2008,25,0.011482254697286013
16,POL,4,5,2,11,2008,24,0.011482254697286013
17,ETH,4,2,1,7,2008,17,0.007306889352818371
18,ROU,4,1,4,9,2008,18,0.009394572025052192
19,CUB,3,10,17,30,2008,46,0.031315240083507306
20,CAN,3,9,8,20,2008,35,0.020876826722338204
21,HUN,3,5,2,10,2008,21,0.010438413361169102
22,NOR,3,5,1,9,2008,20,0.009394572025052192
23,BRA,3,4,10,17,2008,27,0.017745302713987474
24,BLR,3,4,7,14,2008,24,0.014613778705636743
25,CZE,3,3,1,7,2008,16,0.007306889352818371
26,SVK,3,3,0,6,2008,15,0.006263048016701462
27,NZL,3,2,4,9,2008,17,0.009394572025052192
28,GEO,3,2,2,7,2008,15,0.007306889352818371
29,KAZ,2,3,4,9,2008,16,0.009394572025052192
30,DEN,2,2,3,7,2008,13,0.007306889352818371
31,PRK,2,2,2,6,2008,12,0.006263048016701462
31,THA,2,2,2,6,2008,12,0.006263048016701462
33,MGL,2,2,0,4,2008,10,0.0041753653444676405
34,SUI,2,1,4,7,2008,12,0.007306889352818371
35,ARG,2,0,4,6,2008,10,0.006263048016701462
36,MEX,2,0,2,4,2008,8,0.0041753653444676405
37,BEL,2,0,0,2,2008,6,0.0020876826722338203
38,ZIM,1,3,0,4,2008,9,0.0041753653444676405
39,SLO,1,2,2,5,2008,9,0.005219206680584551
40,AZE,1,1,4,6,2008,9,0.006263048016701462
40,INA,1,1,4,6,2008,9,0.006263048016701462
42,BUL,1,1,3,5,2008,8,0.005219206680584551
42,TUR,1,1,3,5,2008,8,0.005219206680584551
44,TPE,1,1,2,4,2008,7,0.0041753653444676405
44,FIN,1,1,2,4,2008,7,0.0041753653444676405
46,LAT,1,1,1,3,2008,6,0.003131524008350731
47,DOM,1,1,0,2,2008,5,0.0020876826722338203
47,EST,1,1,0,2,2008,5,0.0020876826722338203
47,POR,1,1,0,2,2008,5,0.0020876826722338203
47,TTO,1,1,0,2,2008,5,0.0020876826722338203
51,IND,1,0,2,3,2008,5,0.003131524008350731
52,IRI,1,0,1,2,2008,4,0.0020876826722338203
53,CMR,1,0,0,1,2008,3,0.0010438413361169101
53,PAN,1,0,0,1,2008,3,0.0010438413361169101
53,TUN,1,0,0,1,2008,3,0.0010438413361169101
56,SWE,0,4,1,5,2008,9,0.005219206680584551
57,LTU,0,3,2,5,2008,8,0.005219206680584551
57,NGR,0,3,2,5,2008,8,0.005219206680584551
59,CRO,0,2,3,5,2008,7,0.005219206680584551
60,COL,0,2,1,3,2008,5,0.003131524008350731
60,GRE,0,2,1,3,2008,5,0.003131524008350731
62,ARM,0,1,4,5,2008,6,0.005219206680584551
63,UZB,0,1,3,4,2008,5,0.0041753653444676405
64,AUT,0,1,2,3,2008,4,0.003131524008350731
64,IRL,0,1,2,3,2008,4,0.003131524008350731
64,KGZ,0,1,2,3,2008,4,0.003131524008350731
64,SRB,0,1,2,3,2008,4,0.003131524008350731
68,ALG,0,1,1,2,2008,3,0.0020876826722338203
68,BAH,0,1,1,2,2008,3,0.0020876826722338203
68,MAR,0,1,1,2,2008,3,0.0020876826722338203
68,TJK,0,1,1,2,2008,3,0.0020876826722338203
72,CHI,0,1,0,1,2008,2,0.0010438413361169101
72,ECU,0,1,0,1,2008,2,0.0010438413361169101
72,ISL,0,1,0,1,2008,2,0.0010438413361169101
72,MAS,0,1,0,1,2008,2,0.0010438413361169101
72,SAM,0,1,0,1,2008,2,0.0010438413361169101
72,SGP,0,1,0,1,2008,2,0.0010438413361169101
72,RSA,0,1,0,1,2008,2,0.0010438413361169101
72,SUD,0,1,0,1,2008,2,0.0010438413361169101
72,VIE,0,1,0,1,2008,2,0.0010438413361169101
81,EGY,0,0,2,2,2008,2,0.0020876826722338203
82,AFG,0,0,1,1,2008,1,0.0010438413361169101
82,ISR,0,0,1,1,2008,1,0.0010438413361169101
82,MRI,0,0,1,1,2008,1,0.0010438413361169101
82,MDA,0,0,1,1,2008,1,0.0010438413361169101
82,TOG,0,0,1,1,2008,1,0.0010438413361169101
82,VEN,0,0,1,1,2008,1,0.0010438413361169101
1,USA,48,26,30,104,2012,226,0.10833333333333334
2,CHN,39,31,22,92,2012,201,0.09583333333333334
3,GBR,29,18,18,65,2012,141,0.06770833333333333
4,RUS,18,21,26,65,2012,122,0.06770833333333333
5,KOR,13,9,9,31,2012,66,0.03229166666666667
6,GER,11,20,13,44,2012,86,0.04583333333333333
7,FRA,11,11,13,35,2012,68,0.036458333333333336
8,AUS,8,15,12,35,2012,66,0.036458333333333336
9,ITA,8,9,11,28,2012,53,0.029166666666666667
10,HUN,8,4,6,18,2012,38,0.01875
11,JPN,7,14,17,38,2012,66,0.03958333333333333
12,IRI,7,5,1,13,2012,32,0.013541666666666667
13,NED,6,6,8,20,2012,38,0.020833333333333332
14,NZL,6,2,5,13,2012,27,0.013541666666666667
15,UKR,5,4,10,19,2012,33,0.019791666666666666
16,CUB,5,3,7,15,2012,28,0.015625
17,ESP,4,10,6,20,2012,38,0.020833333333333332
18,JAM,4,5,4,13,2012,26,0.013541666666666667
19,CZE,4,4,3,11,2012,23,0.011458333333333333
20,RSA,4,1,1,6,2012,15,0.00625
21,PRK,4,0,2,6,2012,14,0.00625
22,BRA,3,5,9,17,2012,28,0.017708333333333333
23,KAZ,3,2,6,11,2012,19,0.011458333333333333
23,POL,3,2,6,11,2012,19,0.011458333333333333
25,ETH,3,2,3,8,2012,16,0.008333333333333333
26,CRO,3,1,2,6,2012,13,0.00625
27,CAN,2,6,10,18,2012,28,0.01875
28,BLR,2,5,3,10,2012,19,0.010416666666666666
29,KEN,2,4,7,13,2012,21,0.013541666666666667
30,DEN,2,4,3,9,2012,17,0.009375
31,ROU,2,4,1,7,2012,15,0.007291666666666667
32,AZE,2,2,5,9,2012,15,0.009375
33,SUI,2,2,0,4,2012,10,0.004166666666666667
34,NOR,2,1,1,4,2012,9,0.004166666666666667
35,LTU,2,0,3,5,2012,9,0.005208333333333333
36,TUN,2,0,1,3,2012,7,0.003125
37,SWE,1,4,3,8,2012,14,0.008333333333333333
38,COL,1,3,5,9,2012,14,0.009375
39,MEX,1,3,4,8,2012,13,0.008333333333333333
40,GEO,1,2,3,6,2012,10,0.00625
41,IRL,1,1,4,6,2012,9,0.00625
42,ARG,1,1,2,4,2012,7,0.004166666666666667
42,SRB,1,1,2,4,2012,7,0.004166666666666667
42,SLO,1,1,2,4,2012,7,0.004166666666666667
42,TTO,1,1,2,4,2012,7,0.004166666666666667
46,TUR,1,1,1,3,2012,6,0.003125
47,DOM,1,1,0,2,2012,5,0.0020833333333333333
48,TPE,1,0,1,2,2012,4,0.0020833333333333333
48,LAT,1,0,1,2,2012,4,0.0020833333333333333
50,ALG,1,0,0,1,2012,3,0.0010416666666666667
50,BAH,1,0,0,1,2012,3,0.0010416666666666667
50,BRN,1,0,0,1,2012,3,0.0010416666666666667
50,GRN,1,0,0,1,2012,3,0.0010416666666666667
50,UGA,1,0,0,1,2012,3,0.0010416666666666667
50,VEN,1,0,0,1,2012,3,0.0010416666666666667
56,EGY,0,3,1,4,2012,7,0.004166666666666667
57,IND,0,2,4,6,2012,8,0.00625
58,MGL,0,2,3,5,2012,7,0.005208333333333333
59,THA,0,2,2,4,2012,6,0.004166666666666667
60,BUL,0,2,1,3,2012,5,0.003125
60,FIN,0,2,1,3,2012,5,0.003125
60,INA,0,2,1,3,2012,5,0.003125
63,SVK,0,1,3,4,2012,5,0.004166666666666667
64,BEL,0,1,2,3,2012,4,0.003125
65,ARM,0,1,1,2,2012,3,0.0020833333333333333
65,EST,0,1,1,2,2012,3,0.0020833333333333333
65,MAS,0,1,1,2,2012,3,0.0020833333333333333
65,PUR,0,1,1,2,2012,3,0.0020833333333333333
65,QAT,0,1,1,2,2012,3,0.0020833333333333333
70,BOT,0,1,0,1,2012,2,0.0010416666666666667
70,CYP,0,1,0,1,2012,2,0.0010416666666666667
70,GAB,0,1,0,1,2012,2,0.0010416666666666667
70,GUA,0,1,0,1,2012,2,0.0010416666666666667
70,MNE,0,1,0,1,2012,2,0.0010416666666666667
70,POR,0,1,0,1,2012,2,0.0010416666666666667
76,UZB,0,0,3,3,2012,3,0.003125
77,GRE,0,0,2,2,2012,2,0.0020833333333333333
77,SGP,0,0,2,2,2012,2,0.0020833333333333333
79,AFG,0,0,1,1,2012,1,0.0010416666666666667
79,CMR,0,0,1,1,2012,1,0.0010416666666666667
79,HKG,0,0,1,1,2012,1,0.0010416666666666667
79,KUW,0,0,1,1,2012,1,0.0010416666666666667
79,MAR,0,0,1,1,2012,1,0.0010416666666666667
79,KSA,0,0,1,1,2012,1,0.0010416666666666667
79,TJK,0,0,1,1,2012,1,0.0010416666666666667
79,VIE,0,0,1,1,2012,1,0.0010416666666666667
1,USA,46,37,38,121,2016,250,0.12448559670781893
2,GBR,27,23,17,67,2016,144,0.06893004115226338
3,CHN,26,18,26,70,2016,140,0.0720164609053498
4,RUS,19,17,20,56,2016,111,0.05761316872427984
5,GER,17,10,15,42,2016,86,0.043209876543209874
6,JPN,12,8,21,41,2016,73,0.04218106995884774
7,FRA,10,18,14,42,2016,80,0.043209876543209874
8,KOR,9,3,9,21,2016,42,0.021604938271604937
9,ITA,8,12,8,28,2016,56,0.02880658436213992
10,AUS,8,11,10,29,2016,56,0.029835390946502057
11,NED,8,7,4,19,2016,42,0.01954732510288066
12,HUN,8,3,4,15,2016,34,0.015432098765432098
13,BRA,7,6,6,19,2016,39,0.01954732510288066
14,ESP,7,4,6,17,2016,35,0.01748971193415638
15,KEN,6,6,1,13,2016,31,0.013374485596707819
16,JAM,6,3,2,11,2016,26,0.01131687242798354
17,CRO,5,3,2,10,2016,23,0.0102880658436214
18,CUB,5,2,4,11,2016,23,0.01131687242798354
19,NZL,4,9,5,18,2016,35,0.018518518518518517
20,CAN,4,3,15,22,2016,33,0.02263374485596708
21,UZB,4,2,7,13,2016,23,0.013374485596707819
22,COL,3,2,3,8,2016,16,0.00823045267489712
23,SUI,3,2,2,7,2016,15,0.00720164609053498
24,IRI,3,1,4,8,2016,15,0.00823045267489712
25,GRE,3,1,2,6,2016,13,0.006172839506172839
26,ARG,3,1,0,4,2016,11,0.00411522633744856
27,DEN,2,6,7,15,2016,25,0.015432098765432098
28,SWE,2,6,3,11,2016,21,0.01131687242798354
29,RSA,2,6,2,10,2016,20,0.0102880658436214
30,KAZ,2,5,10,17,2016,26,0.01748971193415638
31,UKR,2,5,4,11,2016,20,0.01131687242798354
32,SRB,2,4,2,8,2016,16,0.00823045267489712
33,POL,2,3,6,11,2016,18,0.01131687242798354
34,PRK,2,3,2,7,2016,14,0.00720164609053498
35,BEL,2,2,2,6,2016,12,0.006172839506172839
35,THA,2,2,2,6,2016,12,0.006172839506172839
37,SVK,2,2,0,4,2016,10,0.00411522633744856
38,GEO,2,1,4,7,2016,12,0.00720164609053498
39,AZE,1,7,10,18,2016,27,0.018518518518518517
40,BLR,1,4,4,9,2016,15,0.009259259259259259
41,TUR,1,3,4,8,2016,13,0.00823045267489712
42,ARM,1,3,0,4,2016,9,0.00411522633744856
43,CZE,1,2,7,10,2016,14,0.0102880658436214
44,ETH,1,2,5,8,2016,12,0.00823045267489712
45,SLO,1,2,1,4,2016,8,0.00411522633744856
46,INA,1,2,0,3,2016,7,0.0030864197530864196
47,ROU,1,1,2,4,2016,7,0.00411522633744856
48,BRN,1,1,0,2,2016,5,0.00205761316872428
48,VIE,1,1,0,2,2016,5,0.00205761316872428
50,TPE,1,0,2,3,2016,5,0.0030864197530864196
51,BAH,1,0,1,2,2016,4,0.00205761316872428
51,IOA,1,0,1,2,2016,4,0.00205761316872428
51,CIV,1,0,1,2,2016,4,0.00205761316872428
54,FIJ,1,0,0,1,2016,3,0.00102880658436214
54,JOR,1,0,0,1,2016,3,0.00102880658436214
54,KOS,1,0,0,1,2016,3,0.00102880658436214
54,PUR,1,0,0,1,2016,3,0.00102880658436214
54,SGP,1,0,0,1,2016,3,0.00102880658436214
54,TJK,1,0,0,1,2016,3,0.00102880658436214
60,MAS,0,4,1,5,2016,9,0.0051440329218107
61,MEX,0,3,2,5,2016,8,0.0051440329218107
62,VEN,0,2,1,3,2016,5,0.0030864197530864196
63,ALG,0,2,0,2,2016,4,0.00205761316872428
63,IRL,0,2,0,2,2016,4,0.00205761316872428
65,LTU,0,1,3,4,2016,5,0.00411522633744856
66,BUL,0,1,2,3,2016,4,0.0030864197530864196
67,IND,0,1,1,2,2016,3,0.00205761316872428
67,MGL,0,1,1,2,2016,3,0.00205761316872428
69,BDI,0,1,0,1,2016,2,0.00102880658436214
69,GRN,0,1,0,1,2016,2,0.00102880658436214
69,NIG,0,1,0,1,2016,2,0.00102880658436214
69,PHI,0,1,0,1,2016,2,0.00102880658436214
69,QAT,0,1,0,1,2016,2,0.00102880658436214
74,NOR,0,0,4,4,2016,4,0.00411522633744856
75,EGY,0,0,3,3,2016,3,0.0030864197530864196
75,TUN,0,0,3,3,2016,3,0.0030864197530864196
77,ISR,0,0,2,2,2016,2,0.00205761316872428
78,AUT,0,0,1,1,2016,1,0.00102880658436214
78,DOM,0,0,1,1,2016,1,0.00102880658436214
78,EST,0,0,1,1,2016,1,0.00102880658436214
78,FIN,0,0,1,1,2016,1,0.00102880658436214
78,MAR,0,0,1,1,2016,1,0.00102880658436214
78,NGR,0,0,1,1,2016,1,0.00102880658436214
78,POR,0,0,1,1,2016,1,0.00102880658436214
78,TTO,0,0,1,1,2016,1,0.00102880658436214
78,UAE,0,0,1,1,2016,1,0.00102880658436214
1,USA,39,41,33,113,2020,232,0.10462962962962963
2,CHN,38,32,19,89,2020,197,0.0824074074074074
3,JPN,27,14,17,58,2020,126,0.053703703703703705
4,GBR,22,20,22,64,2020,128,0.05925925925925926
5,ROC,20,28,23,71,2020,139,0.06574074074074074
6,AUS,17,7,22,46,2020,87,0.04259259259259259
7,NED,10,12,14,36,2020,68,0.03333333333333333
8,FRA,10,12,11,33,2020,65,0.030555555555555555
9,GER,10,11,16,37,2020,68,0.03425925925925926
10,ITA,10,10,20,40,2020,70,0.037037037037037035
11,CAN,7,7,10,24,2020,45,0.022222222222222223
12,BRA,7,6,8,21,2020,41,0.019444444444444445
13,NZL,7,6,7,20,2020,40,0.018518518518518517
14,CUB,7,3,5,15,2020,32,0.013888888888888888
15,HUN,6,7,7,20,2020,39,0.018518518518518517
16,KOR,6,4,10,20,2020,36,0.018518518518518517
17,POL,4,5,5,14,2020,27,0.012962962962962963
18,CZE,4,4,3,11,2020,23,0.010185185185185186
19,KEN,4,4,2,10,2020,22,0.009259259259259259
20,NOR,4,2,2,8,2020,18,0.007407407407407408
21,JAM,4,1,4,9,2020,18,0.008333333333333333
22,ESP,3,8,6,17,2020,31,0.01574074074074074
23,SWE,3,6,0,9,2020,21,0.008333333333333333
24,SUI,3,4,6,13,2020,23,0.012037037037037037
25,DEN,3,4,4,11,2020,21,0.010185185185185186
26,CRO,3,3,2,8,2020,17,0.007407407407407408
27,IRI,3,2,2,7,2020,15,0.006481481481481481
28,SRB,3,1,5,9,2020,16,0.008333333333333333
29,BEL,3,1,3,7,2020,14,0.006481481481481481
30,BUL,3,1,2,6,2020,13,0.005555555555555556
31,SLO,3,1,1,5,2020,12,0.004629629629629629
32,UZB,3,0,2,5,2020,11,0.004629629629629629
33,GEO,2,5,1,8,2020,17,0.007407407407407408
34,TPE,2,4,6,12,2020,20,0.011111111111111112
35,TUR,2,2,9,13,2020,19,0.012037037037037037
36,GRE,2,1,1,4,2020,9,0.003703703703703704
36,UGA,2,1,1,4,2020,9,0.003703703703703704
38,ECU,2,1,0,3,2020,8,0.002777777777777778
39,IRL,2,0,2,4,2020,8,0.003703703703703704
39,ISR,2,0,2,4,2020,8,0.003703703703703704
41,QAT,2,0,1,3,2020,7,0.002777777777777778
42,BAH,2,0,0,2,2020,6,0.001851851851851852
42,KOS,2,0,0,2,2020,6,0.001851851851851852
44,UKR,1,6,12,19,2020,27,0.017592592592592594
45,BLR,1,3,3,7,2020,12,0.006481481481481481
46,ROU,1,3,0,4,2020,9,0.003703703703703704
46,VEN,1,3,0,4,2020,9,0.003703703703703704
48,IND,1,2,4,7,2020,11,0.006481481481481481
49,HKG,1,2,3,6,2020,10,0.005555555555555556
50,PHI,1,2,1,4,2020,8,0.003703703703703704
50,SVK,1,2,1,4,2020,8,0.003703703703703704
52,RSA,1,2,0,3,2020,7,0.002777777777777778
53,AUT,1,1,5,7,2020,10,0.006481481481481481
54,EGY,1,1,4,6,2020,9,0.005555555555555556
55,INA,1,1,3,5,2020,8,0.004629629629629629
56,ETH,1,1,2,4,2020,7,0.003703703703703704
56,POR,1,1,2,4,2020,7,0.003703703703703704
58,TUN,1,1,0,2,2020,5,0.001851851851851852
59,EST,1,0,1,2,2020,4,0.001851851851851852
59,FIJ,1,0,1,2,2020,4,0.001851851851851852
59,LAT,1,0,1,2,2020,4,0.001851851851851852
59,THA,1,0,1,2,2020,4,0.001851851851851852
63,BER,1,0,0,1,2020,3,0.000925925925925926
63,MAR,1,0,0,1,2020,3,0.000925925925925926
63,PUR,1,0,0,1,2020,3,0.000925925925925926
66,COL,0,4,1,5,2020,9,0.004629629629629629
67,AZE,0,3,4,7,2020,10,0.006481481481481481
68,DOM,0,3,2,5,2020,8,0.004629629629629629
69,ARM,0,2,2,4,2020,6,0.003703703703703704
70,KGZ,0,2,1,3,2020,5,0.002777777777777778
71,MGL,0,1,3,4,2020,5,0.003703703703703704
72,ARG,0,1,2,3,2020,4,0.002777777777777778
72,SMR,0,1,2,3,2020,4,0.002777777777777778
74,JOR,0,1,1,2,2020,3,0.001851851851851852
74,MAS,0,1,1,2,2020,3,0.001851851851851852
74,NGR,0,1,1,2,2020,3,0.001851851851851852
77,BRN,0,1,0,1,2020,2,0.000925925925925926
77,LTU,0,1,0,1,2020,2,0.000925925925925926
77,NAM,0,1,0,1,2020,2,0.000925925925925926
77,MKD,0,1,0,1,2020,2,0.000925925925925926
77,KSA,0,1,0,1,2020,2,0.000925925925925926
77,TKM,0,1,0,1,2020,2,0.000925925925925926
83,KAZ,0,0,8,8,2020,8,0.007407407407407408
84,MEX,0,0,4,4,2020,4,0.003703703703703704
85,FIN,0,0,2,2,2020,2,0.001851851851851852
86,BOT,0,0,1,1,2020,1,0.000925925925925926
86,BUR,0,0,1,1,2020,1,0.000925925925925926
86,Ghana,0,0,1,1,2020,1,0.000925925925925926
86,GRN,0,0,1,1,2020,1,0.000925925925925926
86,CIV,0,0,1,1,2020,1,0.000925925925925926
86,KUW,0,0,1,1,2020,1,0.000925925925925926
86,MDA,0,0,1,1,2020,1,0.000925925925925926
86,SYR,0,0,1,1,2020,1,0.000925925925925926
1,USA,40,44,42,126,2024,250,0.12127045235803657
2,CHN,40,27,24,91,2024,198,0.0875842155919153
3,JPN,20,12,13,45,2024,97,0.04331087584215592
4,AUS,18,19,16,53,2024,108,0.05101058710298364
5,FRA,16,26,22,64,2024,122,0.061597690086621755
6,NED,15,7,12,34,2024,71,0.032723772858517804
7,GBR,14,22,29,65,2024,115,0.06256015399422522
8,KOR,13,9,10,32,2024,67,0.030798845043310877
9,ITA,12,13,15,40,2024,77,0.03849855630413859
10,GER,12,13,8,33,2024,70,0.03176130895091434
11,NZL,10,7,3,20,2024,47,0.019249278152069296
12,CAN,9,7,11,27,2024,52,0.02598652550529355
13,UZB,8,2,3,13,2024,31,0.012512030798845043
14,HUN,6,7,6,19,2024,38,0.01828681424446583
15,ESP,5,4,9,18,2024,32,0.017324350336862367
16,SWE,4,4,3,11,2024,23,0.010587102983638113
17,KEN,4,2,5,11,2024,21,0.010587102983638113
18,NOR,4,1,3,8,2024,17,0.007699711260827719
19,IRL,4,0,3,7,2024,15,0.006737247353224254
20,BRA,3,7,10,20,2024,33,0.019249278152069296
21,IRI,3,6,3,12,2024,24,0.011549566891241578
22,UKR,3,5,4,12,2024,23,0.011549566891241578
23,ROU,3,4,2,9,2024,19,0.008662175168431183
24,GEO,3,3,1,7,2024,16,0.006737247353224254
25,BEL,3,1,6,10,2024,17,0.009624639076034648
26,BUL,3,1,3,7,2024,14,0.006737247353224254
27,SRB,3,1,1,5,2024,12,0.004812319538017324
28,CZE,3,0,2,5,2024,11,0.004812319538017324
29,DEN,2,2,5,9,2024,15,0.008662175168431183
30,AZE,2,2,3,7,2024,13,0.006737247353224254
30,CRO,2,2,3,7,2024,13,0.006737247353224254
32,CUB,2,1,6,9,2024,14,0.008662175168431183
33,BRN,2,1,1,4,2024,9,0.0038498556304138597
34,SLO,2,1,0,3,2024,8,0.0028873917228103944
35,TPE,2,0,5,7,2024,11,0.006737247353224254
36,AUT,2,0,3,5,2024,9,0.004812319538017324
37,HKG,2,0,2,4,2024,8,0.0038498556304138597
37,PHI,2,0,2,4,2024,8,0.0038498556304138597
39,ALG,2,0,1,3,2024,7,0.0028873917228103944
39,INA,2,0,1,3,2024,7,0.0028873917228103944
41,ISR,1,5,1,7,2024,14,0.006737247353224254
42,POL,1,4,5,10,2024,16,0.009624639076034648
43,KAZ,1,3,3,7,2024,12,0.006737247353224254
44,JAM,1,3,2,6,2024,11,0.005774783445620789
44,RSA,1,3,2,6,2024,11,0.005774783445620789
44,THA,1,3,2,6,2024,11,0.005774783445620789
47,ETH,1,3,0,4,2024,9,0.0038498556304138597
48,SUI,1,2,5,8,2024,12,0.007699711260827719
49,ECU,1,2,2,5,2024,9,0.004812319538017324
50,POR,1,2,1,4,2024,8,0.0038498556304138597
51,GRE,1,1,6,8,2024,11,0.007699711260827719
52,ARG,1,1,1,3,2024,6,0.0028873917228103944
52,EGY,1,1,1,3,2024,6,0.0028873917228103944
52,TUN,1,1,1,3,2024,6,0.0028873917228103944
55,BOT,1,1,0,2,2024,5,0.0019249278152069298
55,CHI,1,1,0,2,2024,5,0.0019249278152069298
55,LCA,1,1,0,2,2024,5,0.0019249278152069298
55,UGA,1,1,0,2,2024,5,0.0019249278152069298
59,DOM,1,0,2,3,2024,5,0.0028873917228103944
60,GUA,1,0,1,2,2024,4,0.0019249278152069298
60,MAR,1,0,1,2,2024,4,0.0019249278152069298
62,DMA,1,0,0,1,2024,3,0.0009624639076034649
62,PAK,1,0,0,1,2024,3,0.0009624639076034649
64,TUR,0,3,5,8,2024,11,0.007699711260827719
65,MEX,0,3,2,5,2024,8,0.004812319538017324
66,ARM,0,3,1,4,2024,7,0.0038498556304138597
66,COL,0,3,1,4,2024,7,0.0038498556304138597
68,KGZ,0,2,4,6,2024,8,0.005774783445620789
68,PRK,0,2,4,6,2024,8,0.005774783445620789
70,LTU,0,2,2,4,2024,6,0.0038498556304138597
71,IND,0,1,5,6,2024,7,0.005774783445620789
72,MDA,0,1,3,4,2024,5,0.0038498556304138597
73,KOS,0,1,1,2,2024,3,0.0019249278152069298
74,CYP,0,1,0,1,2024,2,0.0009624639076034649
74,FIJ,0,1,0,1,2024,2,0.0009624639076034649
74,JOR,0,1,0,1,2024,2,0.0009624639076034649
74,MGL,0,1,0,1,2024,2,0.0009624639076034649
74,PAN,0,1,0,1,2024,2,0.0009624639076034649
79,TJK,0,0,3,3,2024,3,0.0028873917228103944
80,ALB,0,0,2,2,2024,2,0.0019249278152069298
80,GRN,0,0,2,2,2024,2,0.0019249278152069298
80,MAS,0,0,2,2,2024,2,0.0019249278152069298
80,PUR,0,0,2,2,2024,2,0.0019249278152069298
84,CPV,0,0,1,1,2024,1,0.0009624639076034649
84,CIV,0,0,1,1,2024,1,0.0009624639076034649
84,PER,0,0,1,1,2024,1,0.0009624639076034649
84,QAT,0,0,1,1,2024,1,0.0009624639076034649
84,ROT,0,0,1,1,2024,1,0.0009624639076034649
84,SGP,0,0,1,1,2024,1,0.0009624639076034649
84,SVK,0,0,1,1,2024,1,0.0009624639076034649
84,ZAM,0,0,1,1,2024,1,0.0009624639076034649
